0 0 0 0 0 0 0 0 0 0
0 7 9 15 9 4 4 7 5 0
0 5 7 8 8 7 9 2 4 0
0 26 23 24 29 28 24 25 26 0
0 23 20 26 28 27 29 30 22 0
0 12 26 29 20 16 2 6 10 0
0 10 10 10 6 2 4 3 8 6 0
0 10 25 10 6 5 2 4 8 0
0 10 10 10 8 6 3 4 2 0
0 0 0 0 0 0 0 0 0 0
